0011111111
0000011101
0010011001
0010011001
0010011001
0010011001
1110001011
0000000000